NO textures/perso/tile_42_2048.xpm
SO textures/perso/tile_42_2048.xpm
WE textures/perso/tile_42_2048.xpm
EA textures/perso/tile_42_2048.xpm

C 50,60,85
F 97,116,163

111111111111111
111111000111111
111110000011111
1111000N0001111
111000110000111
110000110000011
100001111100001
110000111000011
111000010000111
111100000001111
111110000011111
111111000111111
111111001111111
111111001111111
111111000111111
111110000011111
111100010001111
111000010000111
110000010000011
100001101100001
110000101000011
111000000000111
111100010001111
111110010011111
111111010111111
111111111111111